Name of Facility,County,Total confirmed cases in facility,Total confirmed staff cases in facility,Total confirmed resident cases in facility,Total resident deaths in confirmed and probable cases in facility
Abiitan Mill City,Hennepin,16,10,6,2
Adams Health Care Center,Mower,10,7,3,1
Adapta Fowell Flats,Olmsted,2,2,0,0
Adrian Country Living Cottages,Nobles,2,2,0,0
Aftenro Home,St. Louis,18,15,3,0
Aicota Assisted Living,Aitkin,3,0,3,2
Aicota Health Care Center,Aitkin,100,44,56,22
Aitkin Health Services,Aitkin,13,10,3,0
Alex Assisted Living LLC,Douglas,18,9,9,3
All Saints Senior Living,Scott,73,33,40,5
Amy Johnson Residence Assisted Living,Ramsey,6,3,3,0
Annandale Care Center,Wright,74,41,33,9
Anoka Rehabilitation and Living Center,Anoka,113,52,61,18
Appleridge Assisted Living,Swift,17,2,15,4
Appleton Area Health Care Center,Swift,43,26,17,4
Arbor Garden Place,Olmsted,8,6,2,0
Arbor Glen Senior Living,Washington,14,9,5,0
Arbor Lakes Senior Living,Hennepin,19,10,9,4
Arbor Lane Memory Care,Dakota,5,0,5,0
Arbor Oaks Senior Living,Anoka,47,22,25,1
Arbor Park Living Center,Clay,13,5,8,1
Arbor Terrace,Olmsted,14,3,11,1
Arbors at Ridges,Dakota,14,7,7,1
Arlington Place,Stearns,17,7,10,1
Ashby Living Center,Grant,1,0,1,0
Aspen Grove Assisted Living,St. Louis,5,1,4,3
Assisted Living at North Ridge,Hennepin,28,8,20,6
Assumption Court,Stearns,23,5,18,2
Assumption Home,Stearns,101,59,42,19
At Home Living Wesley Residence,St. Louis,20,5,15,2
Auburn Courts Assisted Living,Carver,13,9,4,0
Auburn Home in Waconia,Carver,10,9,1,0
Auburn Manor,Carver,33,21,12,3
Auburn Meadows Assisted Living,Carver,60,26,34,5
Augustana Assisted Living,Hennepin,34,15,19,4
Augustana Care Apple Valley Villa,Dakota,69,18,51,1
Augustana Care Hastings Health and Rehabilitation,Dakota,81,44,37,5
Augustana Care Health & Rehabilitation in Apple Valley,Dakota,246,107,139,44
Augustana Care Lakeside Campus,Meeker,62,25,37,5
Augustana Chapel View Apartments,Hennepin,2,2,0,0
Augustana Chapel View Care Center,Hennepin,190,41,149,35
Augustana Emerald Crest Victoria,Carver,3,3,0,0
Augustana Kenwood Place,Carlton,1,1,0,0
Augustana Mercy Health Care Center,Carlton,14,12,2,0
Augustana Oakview,Carlton,1,1,0,0
Augustana Park Ridge Apartments of Hastings,Dakota,27,2,25,4
Augustana Regent at Burnsville,Dakota,99,44,55,7
Aurora on France,Hennepin,75,32,43,10
Autumn Glen Senior Living,Anoka,8,3,5,4
Autumn Grace Memory Care,Blue Earth,3,2,1,0
Autumn Hills Assisted Living,Beltrami,9,3,6,0
Avera Granite Falls Care Center,Chippewa,33,5,28,8
Avera Morningside Heights Care Center,Lyon,60,23,37,5
Avera Sunrise Manor Nursing Home,Lincoln,10,5,5,0
Bagley Cornerstone Residence Senior Care,Clearwater,33,14,19,4
Barrett Care Center,Grant,16,12,4,1
Bay View Nursing and Rehabilitation Center,Goodhue,94,31,63,11
Bayshore Residence and Rehab,St. Louis,41,13,28,3
Beehive Homes Duluth,St. Louis,14,8,6,2
Beehive Homes Elk River,Sherburne,23,11,12,6
Bel Rae Senior Living,Ramsey,16,9,7,3
Belgrade Nursing Home,Stearns,58,28,30,7
Benedictine Assisted Living Redwing,Goodhue,35,11,24,6
Benedictine Callista Court,Winona,23,12,11,0
Benedictine Court,Nicollet,1,1,0,0
Benedictine Health Center Innsbruck,Ramsey,169,49,120,30
Benedictine Health Center of Minneapolis,Hennepin,35,20,15,3
Benedictine Living Community Crookston the Summit,Polk,19,4,15,2
Benedictine Living Community Northfield,Dakota,11,6,5,1
Benedictine Living Community Owatonna,Steele,23,21,2,0
Benedictine Living Community Westwood Memory Care,St. Louis,3,1,2,0
Benedictine Living Community of Ada,Norman,5,4,1,0
Benedictine Living Community of Duluth,St. Louis,83,37,46,13
Benedictine Living Community of Shakopee,Scott,1,1,0,0
Benedictine Living Community of St. Peter,Nicollet,49,19,30,6
Benedictine Madonna Meadows,Olmsted,10,8,2,0
Benedictine Senior Living at Steeple Pointe,Hennepin,16,4,12,1
Benedictine St. Crispin Living Community Redwing,Goodhue,21,14,7,2
Bentson Family Assisted Living,Ramsey,10,8,2,0
Bethany Assisted Living,Polk,6,4,2,0
Bethany Residence and Rehabilitation Center,Hennepin,18,11,7,0
Bethany on the Lake,Douglas,71,35,36,7
Bethesda Grand,Kandiyohi,242,150,92,19
Bethesda Park View Village,Renville,1,0,1,0
Bethesda Sunrise Village Assisted Living,Kandiyohi,10,6,4,0
Big Fork Valley Communities Skilled Nursing,Itasca,3,3,0,0
Bigfork Valley Villa,Itasca,7,5,2,0
Birches at Trillium Woods,Hennepin,50,28,22,5
Birchview Gardens,Cass,3,1,2,0
Birchwood Care Home,Hennepin,5,3,2,0
Birchwood Cottages North,Steele,1,1,0,0
Birchwood Cottages South,Steele,10,8,2,0
Birchwood Cottages of North Mankato,Nicollet,3,3,0,0
Birchwood Senior Living Arbors Assisted Living,Washington,30,16,14,0
Birchwood Senior Living Health Care Center,Washington,159,86,73,22
Blaine White Pine I,Anoka,25,15,10,0
Blaine White Pine II,Anoka,35,16,19,8
Boulder Creek Assisted Living,Lyon,9,6,3,0
Boulder Estates,Lyon,14,7,7,1
Boundary Waters Care Center,St. Louis,4,3,1,0
Boutwells Presbyterian Homes The Commons Assisted Living,Washington,13,11,2,0
Boutwells Presbyterian Homes The Gables Skilled Nursing,Washington,62,42,20,7
Breck Home Residential Care Center,Hennepin,14,4,10,3
Bremmer Suites,Fillmore,9,4,5,0
Bridge Water at Hanover,Hennepin,1,1,0,0
BridgeWater at Janesville,Waseca,2,2,0,0
Bridgewater at Mankato,Blue Earth,9,7,2,0
Bridgeway Estates,Morrison,5,2,3,0
Brightondale Memory Care,Ramsey,59,15,44,12
Brook Manor,St. Louis,3,3,0,0
Brookdale Eagan,Dakota,1,1,0,0
Brookdale Eden Pairie,Hennepin,31,10,21,8
Brookdale Edina,Hennepin,48,25,23,1
Brookdale Mankato,Blue Earth,12,8,4,0
Brookdale North Oaks,Ramsey,18,12,6,2
Brookdale Plymouth,Hennepin,26,8,18,6
Brookdale West St. Paul,Dakota,5,2,3,1
Brookdale Winona,Winona,14,4,10,1
Brookridge Assisted Living,Wright,2,2,0,0
Brookside Senior Living,Chippewa,27,12,15,2
Brookstone Manor,Itasca,17,5,12,1
Brookview a Villa Center,Hennepin,87,38,49,8
Browns Valley Health Center,Traverse,5,4,1,0
Bryant House Assisted Living,Hennepin,1,1,0,0
Buffalo Lake Healthcare Center,Renville,39,28,11,1
Buhl Carefree Living,St. Louis,2,2,0,0
Bywood East Health Care,Hennepin,40,7,33,7
Caledonia Rehab and Retirement,Houston,3,3,0,0
Caley House Assisted Living,Mille Lacs,4,2,2,0
Camilia Rose Care Center,Anoka,119,43,76,21
Cannon Rivers Senior Living,Goodhue,3,3,0,0
Capitol Senior Living LLC (Rose Arbor & Wildflower Lodge),Hennepin,47,18,29,11
Capitol View Transitional Care Center,Ramsey,21,12,9,2
Care Age Country Home,Hubbard,10,2,8,1
Care and Rehab - Ostrander,Fillmore,2,2,0,0
"Carefree Assisted Living, Cook",St. Louis,1,1,0,0
Carefree Cottages of Maplewood,Ramsey,7,6,1,1
Carefree Living,Benton,16,12,4,2
Carefree Living Aurora,St. Louis,54,15,39,5
Carefree Living Ely,St. Louis,30,13,17,9
"Carefree Living, Brainerd",Crow Wing,17,7,10,1
"Carefree Living, Burnsville",Dakota,56,15,41,2
Carondelet Village,Ramsey,35,18,17,2
Carondelet Village Care Center,Ramsey,16,15,1,0
Carris Health - Care Center & Therapy Suites,Kandiyohi,84,46,38,11
Carver Ridge Senior Living,Carver,17,11,6,0
Castle Ridge Care Center,Hennepin,53,21,32,2
Castle Ridge Commons Assisted Living,Hennepin,5,3,2,0
Catholic Eldercare River Village East,Hennepin,8,5,3,0
Catholic Eldercare on Main,Hennepin,110,51,59,30
Cedar Court Assisted Living,Mower,1,1,0,0
Cedar Crest of Silver Lake,McLeod,14,3,11,4
Cedars at St. Louis Park A Villa Center,Hennepin,89,36,53,15
Cedars of Austin,Mower,80,25,55,3
Centennial Gardens for Nursing and Rehabilitation,Hennepin,94,36,58,14
Centennial House of Apple Valley,Dakota,47,23,24,6
Centennial Villa Assisted Living,Wright,13,5,8,2
Centra Care Health Sauk Centre,Stearns,57,22,35,7
Centra Care Long Prairie/Meadow Place,Todd,20,12,8,0
Centra Care Melrose,Stearns,109,52,57,18
CentraCare  Monticello Care Center,Wright,100,62,38,11
CentraCare Benedict Homes,Sherburne,5,3,2,0
CentraCare Chateau Waters,Stearns,8,4,4,0
CentraCare Health Paynesville,Stearns,40,28,12,3
CentraCare Long Prairie Care Center,Todd,50,32,18,7
CentraCare Melrose Park View Place,Stearns,33,9,24,1
CentraCare Stearns Place,Stearns,7,3,4,0
CentraCare Washburne Court,Stearns,2,2,0,0
Centracare Benedict Court,Sherburne,3,3,0,0
Central Health Care,Le Sueur,14,12,2,1
Central Minnesota Senior Care Brainerd,Crow Wing,16,8,8,1
Central Todd County Care Center,Todd,56,27,29,9
Central Towers St Paul St Paul,Ramsey,5,4,1,0
Cerenity Marian St. Paul,Ramsey,43,30,13,0
Cerenity Residence of White Bear Lake,Ramsey,14,4,10,3
Cerenity Senior Care Humboldt,Ramsey,109,23,86,31
Cerenity Senior Care Humboldt Assisted Living,Ramsey,15,8,7,0
Cerenity Senior Care Marian,Ramsey,1,0,1,0
Cerenity White Bear Lake Care Center,Ramsey,174,89,85,26
Champlin Shores,Hennepin,25,12,13,4
Chandler Place Senior Living,Ramsey,46,15,31,9
Charter House Senior Living,Olmsted,36,31,5,0
Chaska Heights Senior Living,Carver,36,19,17,0
Cherrywood Advanced Living,Stearns,18,7,11,1
Cherrywood Advanced Living - Andover,Anoka,3,2,1,0
Cherrywood Big Lake,Sherburne,16,6,10,1
Cherrywood Pointe of Forest Lake,Washington,43,14,29,5
Cherrywood Pointe of Minnetonka,Hennepin,26,6,20,5
Cherrywood Pointe of Plymouth,Hennepin,21,12,9,7
Cherrywood Pointe of Roseville - Cleveland,Ramsey,42,13,29,4
Cherrywood Pointe of Roseville at Lexington,Ramsey,11,6,5,1
Chosen Valley Assisted Living,Fillmore,3,0,3,0
Chosen Valley Care Center,Fillmore,54,31,23,5
Chris Jensen Health and Rehabilitation Center,St. Louis,123,45,78,23
Claddagh Senior Living,Houston,19,5,14,1
Clara City Care Center,Chippewa,55,26,29,5
Clara City Senior Living,Chippewa,6,4,2,0
Clark Crossings of Wells,Faribault,3,1,2,0
Clarkfield Care Center,Yellow Medicine,13,11,2,1
Cokato Manor Skilled Nursing & Rehabilitation Facility,Wright,9,9,0,0
Colonial Manor Nursing Home,Jackson,13,12,1,0
Colonial Terrace Assisted Living,Todd,1,0,1,0
Colony Court,Waseca,4,0,4,0
Comfort Residence Blaine,Anoka,7,2,5,1
Comfort Residence Le Sueur,Le Sueur,1,0,1,0
Comfort Residence of St. Louis Park,Hennepin,2,2,0,0
Community Memorial Galeon,Douglas,71,32,39,15
Cook Care Center,St. Louis,7,6,1,1
Copperfield Hill Assisted Living - The Lodge,Hennepin,60,19,41,11
Copperfield Hill The Manor,Hennepin,30,10,20,5
Copperleaf Senior Living,Kandiyohi,39,7,32,2
Cornerstone Assisted Living,Hennepin,36,9,27,5
Cornerstone Nursing and Rehabilitation,Clearwater,70,33,37,5
Cornerstone Residence Fosston,Polk,28,7,21,4
Cornerstone Residence of Bagley,Clearwater,1,1,0,0
Cornerstone Residence of Kelliher,Beltrami,1,1,0,0
Cottagewood Senior Communities 7,Olmsted,36,13,23,4
Cottagewood Senior Community Mankato,Blue Earth,4,4,0,0
Cottagewood Senior Community Rochester Cottage 2,Olmsted,23,10,13,3
Cottagewood Senior Community Rochester Cottage 3,Olmsted,9,3,6,0
Cottagewood Senior Community Rochester Cottage 4,Olmsted,19,8,11,1
Cottagewood Senior Community Rochester Cottage 5,Olmsted,44,18,26,6
Cottagewood Senior Community Rochester Cottage 6,Olmsted,34,13,21,1
Cottagewood Senior Community Rochester Cottage 8,Olmsted,31,15,16,4
Country Manor Campus,Benton,203,92,111,26
Country Manor Senior Apartments,Benton,27,5,22,2
Country Meadows of Milaca,Mille Lacs,14,4,10,0
Country View Senior Living Community,Redwood,1,1,0,0
Countryside Retirement Community,Brown,8,4,4,0
Courage Kenny Rehabilitation Institute,Hennepin,35,31,4,0
Covenant Living of Golden Valley,Hennepin,109,54,55,25
Covenant Living of Golden Valley Assisted Living,Hennepin,13,3,10,5
Creekside Cottage Assisted Living,Anoka,10,2,8,3
Crest View Lutheran Home,Anoka,205,98,107,25
Crest View and 42nd,Anoka,12,2,10,0
Crest View of Blaine,Anoka,42,10,32,11
Crossroads Apartments,Polk,8,3,5,0
Crossroads Care Center,Nobles,52,19,33,7
Crystal Brook Senior Living,Hubbard,7,6,1,1
Crystal Seasons Living Center,Blue Earth,4,4,0,0
Cuyuna Regional Medical Center Care Center,Crow Wing,17,12,5,3
D&D's Caring Hearts,Beltrami,16,6,10,2
Deephaven Woods Senior Living,Hennepin,41,12,29,8
Deer Crest Assisted Living Red Wing,Goodhue,23,10,13,3
Dellwood Gardens,Ramsey,4,3,1,0
Diamond Willow Assisted Living,Morrison,6,4,2,1
Diamond Willow Assisted Living Alexandria,Douglas,3,3,0,0
Diamond Willow Assisted Living Park Rapids,Hubbard,3,2,1,0
Diamond Willow Assisted Living Proctor,St. Louis,15,7,8,3
Diamond Willow Baxter,Crow Wing,1,1,0,0
Diamond Willow Cloquet,Carlton,8,4,4,0
Diamond Willow Detroit Lakes,Becker,29,11,18,1
Diamond Willow Lester Park,St. Louis,4,3,1,0
Diamond Willow Mountain Iron,St. Louis,6,3,3,2
Divine Providence Community Home,Brown,16,13,3,0
Divine Providence Health Center,Lincoln,10,8,2,0
Eagan Pointe Senior Living,Dakota,34,17,17,5
Eastwood Senior Living,Kanabec,18,5,13,2
Ebenezer Care Center,Hennepin,113,43,70,22
Ebenezer Martin Luther Care Center,Hennepin,296,113,183,35
Ebenezer Ridges Care Center,Dakota,118,54,64,4
Ebenezer at Cardigan Ridge Senior Living,Ramsey,22,12,10,0
Ecumen Brooks,Steele,7,3,4,0
Ecumen Countryside,Steele,13,7,6,1
Ecumen Detroit Lakes Cottage,Becker,8,5,3,0
Ecumen Evergreens Moorhead,Clay,7,3,4,1
Ecumen Lakeshore - The Fountains,St. Louis,31,13,18,4
Ecumen Lakeshore - The Shores,St. Louis,3,0,3,0
Ecumen Lakeview Commons,Ramsey,9,6,3,1
Ecumen Meadows,Nobles,10,7,3,0
Ecumen North Branch Assisted Living,Chisago,33,11,22,5
Ecumen North Branch Skilled Nursing,Chisago,22,13,9,0
Ecumen Oaks,McLeod,3,3,0,0
Ecumen Pathstone Living,Blue Earth,62,36,26,1
Ecumen Pines,McLeod,1,1,0,0
Ecumen Prairie Hill,Nicollet,12,1,11,3
Ecumen Prairie Lodge,Hennepin,57,21,36,6
Ecumen Sand Prairie,Nicollet,9,3,6,0
Ecumen Seasons at Apple Valley,Dakota,30,19,11,1
Ecumen Seasons at Maplewood,Ramsey,12,8,4,1
Ecumen of Litchfield Emmaus Place,Meeker,8,6,2,0
Ecumen of Litchfield Gloria Dei,Meeker,1,0,1,0
Eden Prairie Senior Living,Hennepin,8,6,2,1
Edenbrook of Edina,Hennepin,42,14,28,7
Edenbrook of Rochester,Olmsted,59,26,33,6
Edgebrook Care Center,Pipestone,52,34,18,5
Edgebrook Estates Assisted Living,Pipestone,4,1,3,0
Edgemont Place Alzheimer's Special Care Center,Anoka,19,5,14,6
Edgewood Alexandria Senior Living,Douglas,72,30,42,8
Edgewood Brainerd Senior Living,Crow Wing,59,26,33,10
Edgewood Hermantown,St. Louis,65,32,33,4
Edgewood May Creek Assisted Living,Cass,29,9,20,3
Edgewood May Creek Memory Care,Cass,29,12,17,0
Edgewood Sartell,Stearns,9,7,2,1
Edgewood Sartell Assisted Living,Stearns,62,24,38,6
Edgewood Virginia Senior Living,St. Louis,142,47,95,21
Edgewood Vista Baxter,Crow Wing,48,26,22,5
Edgewood Vista Blaine,Anoka,38,14,24,6
Edgewood Vista East Grand Forks Memory Care,Polk,27,4,23,1
ElderCare Homestead of Minnetonka,Hennepin,16,5,11,2
Elim Shores Eden Prairie,Hennepin,12,7,5,0
Elim Wellspring,Mille Lacs,70,21,49,8
Elk Ridge Alzheimer's Special Care Center,Ramsey,51,19,32,8
Elk River Senior Care LLC,Sherburne,21,12,9,2
Elmhurst Commons,Isanti,1,1,0,0
Elmore Assisted Living and Memory Care,Faribault,50,17,33,4
Elysian of Lake City,Goodhue,47,18,29,7
Emerald Crest Burnsville,Dakota,30,12,18,5
Emerald Crest Shakopee,Scott,28,10,18,6
Emeralds at St. Paul LLC,Ramsey,74,29,45,14
Engel Haus,Wright,39,21,18,8
English Rose Suite,Hennepin,1,1,0,0
Epiphany Assisted Living,Anoka,12,5,7,1
Episcopal Church Home of Minnesota,Ramsey,117,64,53,14
Episcopal Homes of Minnesota - The Gardens,Ramsey,32,27,5,1
Essentia Health Grace Home,Big Stone,15,13,2,0
Essentia Health Homestead,Itasca,9,8,1,0
Essentia Health Living Center-Fosston,Polk,18,10,8,2
Essentia Health Oak Crossing,Becker,47,37,10,1
Essentia Health Virginia Care Center,St. Louis,8,4,4,0
Estates at Rush City,Chisago,44,24,20,6
Evansville Care Center,Douglas,38,19,19,5
Evansville Senior Living Assisted Living,Douglas,4,1,3,0
Eventide Fairmont,Clay,22,8,14,3
Eventide Lutheran Home,Clay,184,56,128,36
Eventide the Linden,Clay,5,1,4,0
Evergreen Knoll Assisted Living,Carlton,10,8,2,0
Fair Meadow Nursing Home,Polk,26,17,9,3
Fair Oaks Lodge,Wadena,18,6,12,1
Fairfax Community Home Inc,Renville,32,7,25,3
Fairview Acute Rehabilitation Center,Hennepin,21,14,7,0
Fairview Care Center Dodge Center,Dodge,15,10,5,1
Fairway Pines Senior Living,Stearns,13,6,7,0
Fairway View Neighborhood,Big Stone,6,4,2,0
Falls Landing Assisted Living,Pipestone,1,1,0,0
Faribault Senior Living,Rice,12,8,4,0
Farmstead Living,Clay,8,7,1,1
Field Crest Care Center,Dodge,10,9,1,0
Flourish Senior Living,Hennepin,3,3,0,0
Forensic Nursing Home,Nicollet,17,17,0,0
Foxdale Memory Care,Waseca,2,2,0,0
Franciscan Health Center Duluth,St. Louis,7,7,0,0
Franciscan Sisters of Little Falls,Morrison,23,9,14,3
Franklin Rehabilitation and Healthcare Center,Renville,54,22,32,9
Frazee Care Center,Becker,56,25,31,5
Friendship Court,Faribault,4,1,3,0
Friendship Village of Bloomington,Hennepin,55,29,26,7
Gable Pines at Vadnais Heights,Ramsey,29,13,16,5
Galtier A Villa Center,Ramsey,109,36,73,23
Garden Court Chateau,Itasca,1,1,0,0
Garden View at Hilltop,Meeker,5,4,1,0
Getty Street Assisted Living,Stearns,3,1,2,0
Gil More Manor Nursing Home,Redwood,7,7,0,0
Glacial Trails Memory Care,Pope,4,2,2,0
Glen Oaks Senior Living Campus,Kandiyohi,60,27,33,9
GlenFields Living with Care,McLeod,42,30,12,3
GlenOaks Senior Living Campus Assisted Living,Kandiyohi,18,3,15,2
Glenn Buffalo Assisted Living,Wright,1,1,0,0
Glenwood Village Care Center,Pope,14,13,1,0
Gleseners Assisted Living,Renville,7,5,2,0
Global Pointe Senior Living,Hennepin,10,2,8,4
GoldPine Home,Beltrami,20,11,9,3
Golden Hearts Assisted Living,Sibley,19,5,14,2
Golden Horizons of Crosslake,Crow Wing,2,2,0,0
Golden Horizons of Sandstone,Pine,26,8,18,2
Golden Nest Assisted Living,Hennepin,1,1,0,0
Golden Oaks Assisted Living of Proctor,St. Louis,25,12,13,6
Good Life Senior Living,Washington,3,2,1,0
Good Samaritan Ambassador,Hennepin,78,33,45,10
Good Samaritan Bethany,Crow Wing,112,47,65,25
Good Samaritan International Falls,Koochiching,8,7,1,0
Good Samaritan Lakeview Senior Living Apartments,Otter Tail,3,3,0,0
Good Samaritan Society - Heritage Grove,Polk,1,0,1,0
Good Samaritan Society - Waconia and Westview Acres,Carver,33,24,9,4
Good Samaritan Society - Woodland,Crow Wing,4,1,3,1
Good Samaritan Society Albert Lea,Freeborn,111,54,57,4
Good Samaritan Society Arlington,Sibley,11,9,2,0
Good Samaritan Society Bancroft Creek Estates,Freeborn,12,6,6,0
Good Samaritan Society Battle Lake,Otter Tail,75,32,43,9
Good Samaritan Society Blackduck,Beltrami,45,15,30,8
Good Samaritan Society Brandt Ridge,Watonwan,8,3,5,2
Good Samaritan Society Comforcare,Mower,12,12,0,0
Good Samaritan Society Fairview,Sibley,3,3,0,0
Good Samaritan Society Heritage Place of Roseville,Ramsey,2,1,1,0
Good Samaritan Society Hidden Creek Assisted Living,Freeborn,3,3,0,0
Good Samaritan Society Howard Lake,Wright,22,9,13,4
Good Samaritan Society Inver Grove Heights,Dakota,4,3,1,0
Good Samaritan Society Jackson,Jackson,40,21,19,4
Good Samaritan Society Luverne,Rock,24,19,5,0
Good Samaritan Society Maplewood,Ramsey,47,25,22,5
Good Samaritan Society Mikkelsen Manor,Cottonwood,2,2,0,0
Good Samaritan Society Mountain Lake,Cottonwood,47,26,21,7
Good Samaritan Society Pine River,Cass,19,12,7,1
Good Samaritan Society Specialty Care Community,Hennepin,56,30,26,3
Good Samaritan Society St. James,Watonwan,3,3,0,0
Good Samaritan Society Waconia and Westview Acres,Carver,2,2,0,0
Good Samaritan Society Westbrook,Cottonwood,13,11,2,0
Good Samaritan Society Woodland,Crow Wing,11,10,1,0
Good Samaritan Society of Pipestone,Pipestone,62,28,34,10
Good Samaritan Society of Winthrop,Sibley,10,8,2,0
Good Shepherd Cottages,Benton,9,8,1,0
"Good Shepherd Homes, Inc",Benton,10,8,2,0
Good Shepherd Lutheran Home,Benton,109,68,41,18
Grace Village,Big Stone,4,3,1,0
GracePointe Crossing Commons,Isanti,72,38,34,10
Gracewood Senior Living of Highland,Ramsey,3,0,3,0
Grand Arbor by Knute Nelson,Douglas,68,40,28,3
Grand Meadows Senior Living,McLeod,14,7,7,0
Grand Village,Itasca,51,37,14,0
Grandma's Place Vincent Location,Hennepin,2,2,0,0
Green Lea Senior Living,Fillmore,7,5,2,0
Green Pine Acres Nursing Facility,Wadena,76,39,37,3
Green Prairie Assisted Living,Wabasha,13,3,10,0
Greenleaf Assisted Living,Pennington,18,6,12,2
Guardian Angels - Riverview Landing,Wright,41,18,23,7
Guardian Angels Care Center (Elk River),Sherburne,115,71,44,15
Guardian Angels Health and Rehabilitation Center,St. Louis,80,28,52,14
Guardian Angels by the Lake,Sherburne,35,14,21,2
Gundersen Harmony Care Center,Fillmore,7,4,3,1
Gundersen St. Elizabeth's Care Center - Assisted Living,Wabasha,3,0,3,0
Gunderson Gardens,Goodhue,13,7,6,2
Gunderson Tweeten Care center,Houston,48,23,25,7
Hadley House,Otter Tail,1,1,0,0
Halstadt Living Center,Norman,7,6,1,1
Harmony House Pierz,Morrison,5,3,2,0
Harmony House of Brainerd,Crow Wing,3,2,1,0
Harmony House of Motley 1,Morrison,24,10,14,3
Harmony Place,Fillmore,3,1,2,0
Harmony River Living Center,McLeod,63,41,22,5
Harrison Bay Senior Living,Hennepin,43,19,24,1
Haven Homes Assisted Living,Hennepin,1,1,0,0
Haven Homes Maple Plaine,Hennepin,56,24,32,14
Havenwood Care Center,Beltrami,103,47,56,9
Havenwood Senior Living of Richfield,Hennepin,40,7,33,2
Havenwood of Buffalo,Wright,14,8,6,1
Havenwood of Burnsville,Dakota,18,9,9,2
Havenwood of Minnetonka,Hennepin,10,8,2,1
Hawley Senior Living,Clay,43,16,27,2
Hayes Residence,Ramsey,6,6,0,0
Heartland Senior Living,Martin,33,17,16,5
Heartwood Senior Living Community,Crow Wing,10,6,4,0
Heathers Manor,Hennepin,12,5,7,1
Hendricks Community Hospital Association Nursing Home,Lincoln,6,5,1,1
Heritage Apartments at Lyngblomsten,Ramsey,2,2,0,0
Heritage Commons at Ponds Edge,Hennepin,6,1,5,0
Heritage Court Assisted Living,Houston,1,1,0,0
Heritage Living Center,Hubbard,97,57,40,16
Heritage Living Center Assisted Living,Hubbard,14,5,9,5
Heritage Manor,St. Louis,69,37,32,11
Heritage Place of Mapleton Assisted Living,Blue Earth,13,1,12,0
Heritage Pointe Senior Living,Lyon,43,17,26,7
Heritage of Edina,Hennepin,68,27,41,9
Highland Apartments,Kandiyohi,8,3,5,0
Highland Chateau Health & Rehabilitation Center,Ramsey,23,12,11,1
Highland Senior Living,Morrison,25,10,15,0
Hillcrest Adams,St. Louis,3,2,1,0
Hillcrest Nashwauk,Itasca,6,1,5,0
Hillcrest Rehabilitation Center,Blue Earth,37,29,8,2
Hillcrest Senior Living,Red Lake,19,10,9,1
Hillcrest Suites,St. Louis,2,0,2,0
Hills Crossing,Crow Wing,3,3,0,0
Hilltop Health Care Center,Meeker,44,27,17,9
Hinckley Assisted Living,Pine,9,2,7,0
Hoffman Senior Living,Grant,5,4,1,0
Holly Ridge Manor by Minnewaska Community Health Services,Pope,4,2,2,0
Home Front First,Chippewa,7,2,5,1
Home and Comfort 1,Itasca,18,8,10,3
Homestead of Anoka,Anoka,26,7,19,6
Hopkins Health Services,Hennepin,73,35,38,11
Ingleside a Colony Court Senior Living Solution,Martin,21,7,14,0
Inter-Faith Care Center,Carlton,93,35,58,11
Interlude Restorative Suites - Fridley,Anoka,252,12,240,55
Interlude Restorative Suites Plymouth,Hennepin,44,23,21,7
Inverwood Senior Living,Dakota,25,12,13,5
Iris Park Commons,Ramsey,13,11,2,1
Ivy Hill Senior Care,Rice,9,4,5,0
JA Wedum Residential Hospice,Hennepin,8,2,6,4
Jasper Sunrise Village,Pipestone,1,1,0,0
John Paul Apartments,Stearns,8,0,8,1
Johnson Memorial Health Services,Lac qui Parle,38,15,23,8
Jones Harrison Residence,Hennepin,128,60,68,23
Jones-Harrison Assisted Living,Hennepin,13,7,6,2
Jourdain Perpich Extended Care Center,Beltrami,26,6,20,4
Karlstad Healthcare Center,Kittson,19,6,13,6
Keller Lake Commons,Sherburne,8,6,2,0
Kenyon Sunset Home,Goodhue,1,1,0,0
Keystone Bluffs Assisted Living,St. Louis,62,21,41,12
Keystone Place at LaValle Fields,Washington,37,15,22,5
Kingsley Shores Senior Living,Dakota,43,9,34,9
Kingsway Retirement Living,Scott,5,3,2,0
Kittson Healthcare Nursing Home,Kittson,80,19,61,13
Knollwood Place Apartments,Hennepin,18,9,9,1
Knute Nelson Care Center,Douglas,98,45,53,7
LB Alcott Manor,Otter Tail,1,0,1,0
LB Broen Home,Otter Tail,47,40,7,0
La Crescent Health Services,Houston,23,5,18,3
Lake City Care Center,Goodhue,116,51,65,14
Lake Minnetonka Shores Assisted Living,Hennepin,15,11,4,0
Lake Ridge Assisted Living,Wright,18,12,6,0
Lake Ridge Care Center,Wright,12,10,2,1
Lake Shore Inn Nursing Home,Waseca,39,21,18,8
Lake Winona Manor,Winona,72,33,39,12
Lakeside Generations Assisted Living,Meeker,29,4,25,1
Lakeside Medical Center,Pine,26,11,15,6
Lakeview Methodist Healthcare Center,Martin,27,20,7,0
Lakeview Senior Housing,Lyon,1,1,0,0
Lakewood Care Center,Lake of the Woods,8,8,0,0
Lakewood Health System Care Center,Wadena,46,22,24,3
Lakewood Manor,Todd,2,1,1,0
Lakewood Pines,Wadena,12,5,7,0
Landings of Minnetonka,Hennepin,34,7,27,3
Landings of Sauk Rapids,Benton,13,3,10,2
Landmark of Fridley,Anoka,33,15,18,7
Lange Board and Room Inc,Sherburne,1,0,1,0
Langton Shores,Ramsey,31,21,10,2
Laurel's Peak Care & Rehab Center,Blue Earth,52,25,27,10
Laurels Edge Assisted Living,Blue Earth,24,11,13,1
Legacy of Brownsdale,Mower,5,4,1,0
Lewiston Senior Living,Winona,3,3,0,0
Lexington Pointe Senior Living,Dakota,1,1,0,0
Life Sprk Summit Place,Hennepin,30,14,16,4
LifeCare Roseau Manor,Roseau,56,34,22,6
Lifecare Greenbush Manor,Roseau,60,36,24,2
Lilac Homes Assisted Living & Memory Care,Clay,21,3,18,9
Lilac Homes Assisted Living & Memory Care Dilworth,Clay,1,1,0,0
Lilydale Senior Living,Dakota,12,10,2,0
Lincoln Park Assisted Living,Becker,3,2,1,1
Lindenwood Assisted Living,Murray,10,2,8,0
Lino Lakes Assisted Living,Anoka,59,18,41,7
Lino Lakes Gracewood,Anoka,14,5,9,1
Little Falls Health Services Care Center,Morrison,33,26,7,0
Little Fork Care Center,Koochiching,2,2,0,0
Little Sisters of the Poor Holy Family Residence,Ramsey,50,30,20,1
Living Meadows at Luther Madelia,Watonwan,25,15,10,4
Lodge of Winthrop,Sibley,1,1,0,0
Long Lake Assisted Living,Hennepin,1,1,0,0
Loren on Park,Hennepin,21,7,14,2
Luther Haven,Chippewa,87,38,49,9
Lutheran Home Association Nursing Home,Scott,22,11,11,1
Lyngblomsten Apartments,Ramsey,2,0,2,1
Lyngblomsten Care Center,Ramsey,258,123,135,45
Madison Healthcare Services Care Center,Lac qui Parle,46,19,27,1
Madonna Summit of Byron,Olmsted,5,3,2,0
Madonna Towers of Rochester AL,Olmsted,24,19,5,1
Madonna Towers of Rochester SNF,Olmsted,14,10,4,0
Mahnomen Area Assisted Living Center,Mahnomen,1,0,1,0
Mahnomen Health Center,Mahnomen,9,3,6,0
MainStreet Lodge,Hennepin,18,7,11,0
Majestic Pines,Itasca,21,14,7,2
Mala Strana Care and Rehab Center,Scott,128,52,76,21
Maple Hill Senior Living,Ramsey,12,5,7,1
Maple Lawn Senior Care,Murray,30,22,8,2
Maple Woods Assisted Living,Itasca,2,2,0,0
Maple Woods Assisted Living Deer River,Itasca,21,0,21,7
Mapleton Community Home,Blue Earth,93,48,45,8
Maplewood Care Center,Ramsey,127,57,70,22
Maplewood Court Assisted Living,Murray,17,6,11,2
Maplewood Manor,Grant,3,1,2,1
Maranatha Care Center,Hennepin,49,34,15,5
Martin Luther Campus - Meadow Woods Assisted Living,Hennepin,80,11,69,7
Mary T Inc- Eagle Crest Assisted Living,Anoka,4,4,0,0
Marywood Assisted Living,St. Louis,11,8,3,1
McCornell Court,Otter Tail,4,2,2,0
McIntosh Senior Living,Polk,79,40,39,10
Meadow Lakes Senior Living,Olmsted,13,7,6,0
Meadow Lane Rehabilitation and Healthcare Center,Swift,33,15,18,4
Meadow Manor,Mower,3,2,1,0
Meadow Ridge Senior Living,Hennepin,37,14,23,8
Meadows on Fairview,Chisago,11,7,4,1
Meadows on Main,Renville,3,2,1,0
Medford Senior Care,Steele,2,2,0,0
Medina Senior Living (Okalee of Medina),Hennepin,1,0,1,0
Meeker Manor Rehab Center LLC,Meeker,62,23,39,10
Meridian Manor,Hennepin,32,13,19,3
Milaca Elim Home,Mille Lacs,121,64,57,23
Milestone Senior Living,Rice,48,12,36,9
Mill City Senior Living,Rice,21,10,11,3
Mill Street Residence,Otter Tail,12,8,4,0
Mille Lacs Health System LTC,Mille Lacs,31,11,20,0
Millers Landing Senior Living,Hennepin,6,5,1,0
Mills Manor,Otter Tail,14,4,10,3
Millstream Commons Northfield,Rice,8,4,4,0
Minnehaha Senior Living,Hennepin,16,12,4,0
Minneota Manor Health Care Center,Lyon,75,42,33,12
Minnesota Masonic Home Bloomington,Hennepin,136,70,66,21
Minnesota Masonic Home Heritage Hall,Hennepin,1,0,1,0
Minnesota Veteran's Home Fergus Falls,Otter Tail,70,44,26,5
Minnesota Veteran's Home Hastings,Dakota,13,8,5,0
Minnesota Veterans Home Luverne,Rock,48,48,0,0
Minnesota Veterans Home Silver Bay,Lake,91,56,35,11
Minnesota Veterans Home in Minneapolis,Hennepin,170,113,57,14
Minnetonka Emerald Crest by Augustana Care,Hennepin,31,14,17,10
Minnewaska Lutheran Home,Pope,22,10,12,2
Mission Nursing Home,Hennepin,62,30,32,9
Moorhead Rehabilitation and Healthcare Center,Clay,39,7,32,10
Mother of Mercy Assisted Living,Stearns,59,31,28,5
Mother of Mercy Nursing Home,Stearns,54,36,18,10
Mount Olivet Careview Home,Hennepin,123,68,55,19
Mount Olivet Home,Hennepin,46,18,28,2
Mount Royal Pines III Assisted Living,St. Louis,5,2,3,0
Mount St Benedict Crookston Campus,Polk,13,4,9,0
Nagel Assisted Living,Carver,5,5,0,0
Nature's Point Assisted Living,Stearns,4,3,1,0
Nelson Gables by Knute Nelson,Douglas,41,13,28,2
New Brighton Care Center,Ramsey,63,26,37,7
"New Brighton, A Villa Center",Ramsey,47,12,35,7
New Harmony Care and Rehab Center,Ramsey,96,38,58,18
New Journey Residence Biwabik,St. Louis,1,1,0,0
New Journey Residence Eveleth,St. Louis,17,5,12,4
New Perspective Carlson Parkway,Hennepin,42,15,27,13
New Perspective Cloquet,Carlton,10,4,6,1
New Perspective Columbia Heights,Anoka,29,16,13,4
New Perspective Eagan,Dakota,3,3,0,0
New Perspective Faribault,Rice,25,12,13,0
New Perspective Highland Park,Ramsey,26,10,16,8
New Perspective Mahtomedi,Washington,1,1,0,0
New Perspective Mankato,Blue Earth,54,22,32,4
New Perspective Prior Lake,Scott,7,6,1,1
New Perspective Roseville,Ramsey,59,16,43,12
New Perspective Waconia,Carver,7,6,1,0
New Perspective-Woodbury,Washington,19,9,10,0
New Richland Care Center,Waseca,60,30,30,5
Nine Mile Creek Senior Living,Hennepin,26,10,16,4
Norris Square Assisted Living,Washington,25,16,9,3
North Ridge Health and Rehab,Hennepin,575,116,459,101
Northern Horizon Homes,Roseau,5,3,2,0
Northern Lakes Senior Living,Crow Wing,29,12,17,3
Northern Lights Assisted Living,Clay,1,0,1,0
Northern Pines Assisted Living,Pine,2,2,0,0
Northern Pines Care Center,St. Louis,7,6,1,0
Northfield Care Center Inc,Rice,31,19,12,4
Northfield Hospital Long Term Care Center,Dakota,9,7,2,0
Northfield Retirement Community Parkview,Rice,24,20,4,2
Northstar Manor,Marshall,45,19,26,5
Nouis Home Care,Morrison,18,1,17,1
Nursing Home at Ecumen Detroit Lakes,Becker,102,61,41,12
Oak Crest Senior Housing,Roseau,3,3,0,0
Oak Grove Care Center,Hennepin,2,2,0,0
Oak Hill Assisted Living,Itasca,5,1,4,0
Oak Hills Assisted Living,Brown,3,3,0,0
Oak Hills Living Center,Brown,78,39,39,7
Oak Meadows Senior Living,Washington,23,11,12,5
Oak Park Place,Freeborn,11,5,6,1
Oak Park Senior Living,Washington,24,8,16,6
Oak Ridge Assisted Living of Hastings,Dakota,1,0,1,0
Oak Terrace Assisted Living,Nicollet,136,65,71,20
Oak Terrace Health Care Center,Sibley,25,16,9,2
Oak Terrace Senior Housing of Gaylord,Sibley,13,12,1,1
Oak Terrace Senior Housing of Jordan,Scott,4,4,0,0
Oak Terrace Senior Housing of Le Sueur,Le Sueur,2,2,0,0
Oakland Park Communities,Pennington,16,13,3,1
Oaklawn Rehabilitation Center,Blue Earth,20,17,3,1
Oakridge Place LTC Stillwater,Washington,1,1,0,0
Old Main Village,Blue Earth,8,8,0,0
Olive Branch Estates,Carver,2,2,0,0
Olivia Restorative Care Center,Renville,23,17,6,0
Options Residential Gabrie,Dakota,1,1,0,0
Orchard Hill Senior Living,Brown,34,12,22,2
Orchard of Minnetonka,Hennepin,20,11,9,1
Ortonville Fairway View,Big Stone,16,9,7,2
Osseo Gardens Assisted Living,Hennepin,4,2,2,1
Our Circle of Friends Main Court,Rice,1,1,0,0
Our House Senior Living,Mower,10,1,9,0
Our House Senior Living 15th Ave.,Mower,3,1,2,0
PHS Beacon Hill,Hennepin,8,6,2,0
Park Gardens Assisted Living,Otter Tail,14,1,13,1
Park Health A Villa Center,Hennepin,14,11,3,0
Park Lane Estates,Fillmore,1,0,1,0
Park River Estates Care Center,Anoka,116,32,84,26
Park Shores Senior Community,Hennepin,34,8,26,7
Park Terrace Assisted Living,Wright,16,9,7,0
Park View Care Center,Wright,150,72,78,23
Parker Oaks Senior Living,Faribault,27,8,19,1
Parks Place Memory Care,Hennepin,12,5,7,4
Parkshore Senior Campus LLC,Hennepin,9,6,3,1
Parkview Care Center of Heartland Senior Living,Faribault,41,25,16,3
Parkview Court,Pope,3,2,1,0
Parkview Home,Redwood,8,7,1,0
Parkview Manor Nursing Home,Nobles,29,11,18,8
Parmly On The Lake,Chisago,85,38,47,10
Parmly on the Lake Assisted Living,Chisago,4,1,3,0
Parmly on the Lake Isabelle's House,Chisago,14,6,8,3
Peaceful Lodge Assisted Living,Washington,13,8,5,0
Pelican Landing,Becker,19,10,9,1
Pelican Valley Health Center,Otter Tail,18,17,1,0
Perham Living,Otter Tail,39,22,17,2
Perham Living Northwinds,Otter Tail,2,2,0,0
Peterson Colonial Homes,St. Louis,3,1,2,1
Pheasants Ridge,Nicollet,5,4,1,1
Pierz Villa,Morrison,49,27,22,4
Pillars of Mankato,Blue Earth,13,7,6,2
Pillars of Prospect Park,Hennepin,4,4,0,0
Pine Haven Care Center,Goodhue,19,13,6,1
Pioneer Care Center,Otter Tail,82,42,40,6
Pioneer Memorial Care Center,Polk,19,17,2,1
Pioneer Pointe,Otter Tail,2,2,0,0
Pioneer Senior Cottages Heritage,Otter Tail,64,20,44,4
Pleasant Manor Care,Rice,18,16,2,0
Pleasant View Estates,Rice,2,1,1,0
Polar Ridge Senior Living,Ramsey,35,13,22,2
Praha Village,Le Sueur,33,8,25,3
Prairie Bluffs Senior Living,Hennepin,24,9,15,2
Prairie Home Fieldcrest,Lyon,16,5,11,2
Prairie Manor Care center,Steele,12,10,2,0
Prairie Pines Community,Polk,2,1,1,0
Prairie Senior Cottages,Isanti,2,1,1,0
Prairie Senior Cottages New Ulm,Brown,2,2,0,0
Prairie Senior Cottages of Albert Lea,Freeborn,1,1,0,0
Prairie Senior Cottages of Alexandria,Douglas,13,3,10,3
Prairie Senior Cottages of Hutchinson,McLeod,11,2,9,2
Prairie View Assisted Living,Renville,27,11,16,7
Prairie View Senior Living,Lyon,56,22,34,6
Prelude Homes and Services - Woodbury South,Washington,37,18,19,2
Prelude Homes and Services White Bear Lake,Ramsey,30,13,17,6
Presbyterian Homes - Lake Minnetonka Shores,Hennepin,55,26,29,10
Presbyterian Homes - Norris Square,Washington,33,22,11,7
Presbyterian Homes - Valley Ridge,Dakota,13,6,7,1
Presbyterian Homes - Waverly Gardens Assisted Living,Ramsey,26,16,10,3
Presbyterian Homes Bloomington TCU,Hennepin,48,37,11,2
Presbyterian Homes Eagle Crest,Ramsey,12,5,7,1
Presbyterian Homes Founders Ridge,Hennepin,26,15,11,3
Presbyterian Homes GracePointe Crossing Gables,Isanti,141,87,54,15
Presbyterian Homes Mckenna Crossing,Scott,43,20,23,7
Presbyterian Homes Orchard Path,Dakota,20,11,9,3
Presbyterian Homes St. Andrew's Village,Washington,19,11,8,5
Presbyterian Homes and Services - Maranatha,Hennepin,16,5,11,3
Presbyterian Homes and Services Croixdale,Washington,12,3,9,2
Presbyterian Homes of Arden Hills,Ramsey,117,63,54,23
Presbyterian Homes of Bloomington,Hennepin,33,23,10,0
Primrose Retirement Communities of Duluth,St. Louis,10,4,6,0
Primrose Retirement Community of Austin,Mower,25,10,15,1
Primrose Retirement Community of Mankato,Blue Earth,2,2,0,0
Providence Place SNF,Hennepin,165,74,91,16
Providence Villa Sebeka,Wadena,4,4,0,0
Quinlan Care Home,Ramsey,11,3,8,1
Ramsey County Care Center,Ramsey,61,29,32,8
Regina Assisted Living,Dakota,54,12,42,5
Regina Senior Living,Dakota,71,36,35,9
RenVilla Health Center,Renville,43,16,27,18
Restful Living St. Paul,Ramsey,2,1,1,0
Richfield A Villa Center,Hennepin,98,30,68,6
Richfield Senior Housing Mainstreet Village,Hennepin,18,12,6,2
Ridge View Estates,Pipestone,12,8,4,0
Ridgeview Le Seuer Nursing and Rehab Center,Le Sueur,45,29,16,5
Ridgeview Place Senior Living,Benton,9,6,3,3
Ridgeway on 23rd,Brown,6,2,4,1
Ridgeway on German,Brown,9,8,1,0
Riley Crossing Senior Living,Carver,8,6,2,0
River Bend Assisted Living and Memory Care,Olmsted,15,4,11,0
River Grand Senior Living,Itasca,32,16,16,0
River Oaks at Lake Pepin,Wabasha,1,1,0,0
River Oaks at Shady Ridge,McLeod,4,4,0,0
River Oaks at Watertown,Carver,32,17,15,1
River Oaks of Anoka,Anoka,55,24,31,5
River Pointe Senior Living,Clay,6,2,4,0
River Valley Health and Rehabilitation Center,Redwood,64,23,41,16
RiverView Care Center,Polk,7,3,4,1
Riverfront Manor,Otter Tail,3,2,1,0
Riverfront on Main,Otter Tail,10,10,0,0
Rivers Edge Assisted Living,Aitkin,2,2,0,0
Riverside Assisted Living Pillager,Cass,13,3,10,0
Riverside Assisted Living Pine River,Cass,2,0,2,0
Robbinsdale A Villa Center,Hennepin,25,14,11,2
Rochester East Health Services,Olmsted,34,18,16,5
Rochester Rehabilitation and Living Center,Olmsted,28,18,10,2
Rochester West Health Services,Olmsted,24,7,17,0
Roitenberg Assisted Living,Hennepin,33,17,16,8
Rose Haven Assisted Living,Wadena,29,19,10,1
Rose of Sharon A Villa Center,Ramsey,55,15,40,9
Rosewood Senior Living,Isanti,32,11,21,4
Royce Place Assisted Living,Anoka,5,5,0,0
Rushseba Silver Creek Senior Communities,Chisago,15,12,3,0
Sacred Heart Care Center,Mower,100,51,49,16
Saint Ann's Residence,St. Louis,31,2,29,12
Saint Anne of Winona,Winona,72,26,46,8
Saint John's Lutheran Home,Freeborn,32,22,10,1
Saint Therese Transitional Care Services,Hennepin,7,5,2,0
Samaritan Bethany Home on Eighth,Olmsted,62,53,9,0
Samaritan House Elmwood,Crow Wing,8,2,6,3
Sanctuary at West St. Paul,Dakota,53,16,37,3
Sandstone Healthcare Center,Pine,2,2,0,0
Sanford Health Sylvan Court,Yellow Medicine,58,26,32,8
Sanford Health Sylvan Place,Yellow Medicine,8,3,5,1
Sanford Health WoodsEdge Senior Living Neilson Place,Beltrami,20,18,2,0
Sauer Nursing Home,Winona,73,29,44,15
Savage Senior Living at Fen Pointe,Scott,31,9,22,3
Savanna Prairie Assisted Living,Stearns,1,1,0,0
Scandi Haven Village,Swift,23,8,15,2
School Sisters of Notre Dame,Blue Earth,9,5,4,1
Seasons Healthcare,Martin,40,20,20,6
Select Senior Living of Coon Rapids,Anoka,25,9,16,2
"Senior Class Community, LLC",Crow Wing,6,2,4,1
Serenity Assisted Living and Memory Care,Clay,9,5,4,0
Serenity Living Center West Campus,Clay,28,7,21,0
Serenity Living Solutions Remer,Cass,5,5,0,0
Serenity Living Solutions Sebeka,Wadena,11,6,5,0
Serenity Living Solutions of Blackduck,Beltrami,1,1,0,0
Serenity Place on 7th,Stearns,12,8,4,0
Serenity Suites Senior Living,Redwood,13,6,7,2
Serenity Village at Avon,Stearns,21,10,11,1
Serving Hart Assisted Living,St. Louis,9,1,8,1
Seven Hills Senior Living,Ramsey,5,2,3,0
Shakopee Friendship Manor,Scott,43,16,27,5
Shepherd Court Apartments,Benton,11,8,3,1
Shiloh Assisted Living,Crow Wing,3,3,0,0
Shirley Chapman Sholom Home East,Ramsey,120,64,56,14
Sholom Home West,Hennepin,123,67,56,21
Sholom Menorah Plaza,Hennepin,30,11,19,3
Shoreview Senior Living,Ramsey,30,8,22,7
Shorewood Senior Campus,Olmsted,10,4,6,4
Signe Burckhardt Manor,Hennepin,4,3,1,0
Silver Creek on Main,Hennepin,42,15,27,7
Silvercrest Brightondale Senior Community Campus,Ramsey,1,1,0,0
SisterCare,Faribault,13,6,7,0
Skylight Gardens Assisted Living,Stearns,40,15,25,3
Skyview Court,Stevens,7,5,2,1
Skyview Plaza,Stevens,8,3,5,3
Sleepy Eye Care Center,Brown,82,37,45,9
South Shore Care Center,Nobles,69,32,37,9
South View Living Center,Sibley,12,2,10,1
Southside Care Center,Hennepin,1,1,0,0
Southview Acres Healthcare Center,Dakota,296,116,180,60
Southview Senior Living,Dakota,3,2,1,0
Spirit Valley Assisted Living,St. Louis,1,0,1,0
Spring Grove Assisted Living,Houston,1,1,0,0
Spring Valley Living,Fillmore,10,8,2,1
Spring Valley Living Assisted Living,Fillmore,4,3,1,0
SpringBrook Village of La Crescent LLC,Houston,22,6,16,1
St Benedicts Senior Community Therapy Suites,Stearns,11,7,4,0
St Johns Abbey,Stearns,5,5,0,0
St. Anthony Health and Rehabilitation,Ramsey,87,35,52,17
St. Anthony Park Home Inc.,Ramsey,67,41,26,7
St. Benedict's Senior Community,Sherburne,207,71,136,17
St. Benedicts Senior Community The Court,Wright,75,29,46,10
St. Clare Living Community of Mora,Kanabec,75,38,37,5
St. Cloud VA- Community Living Center,Stearns,44,6,38,10
St. Elizabeths Health Care Center and Nursing,Wabasha,3,1,2,0
St. Elizabeths Nursing Home,Wabasha,10,1,9,0
St. Francis Home Breckenridge,Wilkin,19,9,10,3
St. Gertrude's Health and Rehabilitation Center,Scott,90,50,40,11
St. John Lutheran Home,Brown,23,14,9,1
St. John's Lutheran The Meadows Assisted Living,Freeborn,10,9,1,0
St. John's Lutheran The Woodlands Nursing Home,Freeborn,29,25,4,0
St. Luke's Lutheran Care Center,Faribault,35,23,12,3
St. Mark's Lutheran Home,Mower,19,10,9,0
St. Otto's Care Center,Morrison,65,35,30,8
St. Scholastica Convent,Sherburne,19,17,2,1
St. Therese Senior Services at Oxbow Lake,Hennepin,52,31,21,5
St. Therese of New Hope Residence Assisted Living,Hennepin,28,5,23,6
St. Therese of New Hope Skilled Nursing,Hennepin,305,98,207,80
St. Therese of Woodbury,Washington,82,32,50,7
St. William's Living Center,Otter Tail,50,28,22,3
Sterling Park Commons,Stearns,8,3,5,1
Sterling Park Gardens,Stearns,8,0,8,1
Sterling Park Senior Living,Stearns,55,15,40,11
Sterling Pointe Senior Living,Mille Lacs,20,13,7,0
Stewartville Care Center,Olmsted,77,35,42,10
Stonebay Senior Living,Hennepin,3,1,2,0
Stonecrest Assisted Living,Washington,35,8,27,3
Stonehaven of Eagan Senior Living,Dakota,24,13,11,2
Stoney River Ramsey,Anoka,29,5,24,3
Sugar Loaf Senior Living,Winona,11,10,1,0
Suite Living Memory Care and Assisted Living - Little Canada,Ramsey,8,5,3,1
Suite Living of Roseville,Ramsey,2,2,0,0
Suite Living of Vadnais Heights,Ramsey,1,1,0,0
SummerWood of Chanhassen,Hennepin,5,4,1,1
SummerWood of Plymouth,Hennepin,13,7,6,0
Summit Hill Senior Living,Ramsey,11,4,7,1
Suncrest Senior Living,Carlton,1,1,0,0
Sunlight Senior Living,Ramsey,3,2,1,0
Sunnyside Care Center,Becker,30,13,17,4
Sunnyside Health Care Center,Carlton,58,28,30,7
Sunrise Village of Milaca,Mille Lacs,2,0,2,0
Sunrise of Edina,Hennepin,22,17,5,3
Sunrise of Golden Valley,Hennepin,24,11,13,4
Sunrise of Minnetonka,Hennepin,8,8,0,0
Sunrise of Roseville,Ramsey,8,5,3,1
THE KENWOOD,Hennepin,5,5,0,0
Talahi Senior Campus Nursing Home,Sherburne,39,25,14,5
Talamore Senior Living,Stearns,3,2,1,0
Tamarac Senior Living Community,Marshall,6,0,6,0
Tamarack Court Assisted Living,Beltrami,15,6,9,0
Temperance Lake Ridge,Martin,18,9,9,4
The Academy of Our Lady of Lourdes Assisi Heights,Olmsted,31,29,2,1
The Alton Memory Care,Ramsey,22,13,9,2
The Beacon at Lake Crystal,Blue Earth,12,4,8,1
The Commons on Marice,Dakota,34,11,23,11
The Country Place,Polk,20,3,17,3
The Emeralds Grand Rapids Assisted Living,Itasca,3,2,1,1
The Emeralds at Faribault,Rice,115,58,57,16
The Emeralds at Grand Rapids,Itasca,51,19,32,12
The Encore at Champlin,Hennepin,17,8,9,0
The Encore at Hugo,Washington,22,6,16,10
The Encore at Mahtomedi,Washington,27,10,17,5
The Encore at Maplewood,Ramsey,18,6,12,3
The Encore at North Branch,Chisago,3,3,0,0
The Estates at Bloomington,Hennepin,34,15,19,6
The Estates at Chateau,Hennepin,46,20,26,1
The Estates at Delano,Wright,57,9,48,1
The Estates at Excelsior,Hennepin,56,17,39,16
The Estates at Fridley,Anoka,57,24,33,3
The Estates at Greeley,Washington,57,22,35,8
The Estates at Linden,Washington,46,14,32,6
The Estates at Lynnhurst,Ramsey,48,15,33,7
The Estates at Roseville LLC,Ramsey,182,53,129,25
The Estates at St. Louis Park,Hennepin,127,63,64,23
The Estates at Twin Rivers,Anoka,53,13,40,2
The Evangelical Lutheran Good Samaritan Society Stillwater,Washington,57,24,33,10
The Evangelical Lutheran Good Samaritan Society Windom,Cottonwood,91,43,48,8
The Farmstead,Anoka,32,14,18,5
The Fountains at Hosana,Dakota,12,12,0,0
The Gardens at Foley,Benton,138,70,68,12
The Gardens at St. Gertrudes,Scott,4,1,3,0
The Gardens at Winsted,McLeod,49,22,27,5
The Gardens of Cannon Falls,Goodhue,37,12,25,10
The Glenn Buffalo Memory Care,Wright,12,3,9,2
The Glenn Hopkins The Terraces,Hennepin,40,21,19,8
The Glenn Minnetonka,Hennepin,26,9,17,8
The Green Prairie Rehab Center,Wabasha,7,7,0,0
The Harbors Senior Living,Anoka,22,8,14,4
The Haven and The Harbor at Peace Village,Carver,43,20,23,5
The Homestead at Coon Rapids,Anoka,35,6,29,5
The Homestead of Maplewood,Ramsey,27,11,16,5
The Hummingbird,St. Louis,18,5,13,1
The Legacy Assisted Living,Stevens,6,3,3,1
The Legacy of Delano,Wright,8,7,1,0
The Legacy of Farmington,Dakota,33,23,10,1
The Legacy of St. Anthony,Hennepin,15,10,5,0
The Legacy of St. Michael,Wright,18,12,6,0
The Lodge,Washington,14,9,5,1
The Lodge at Mountain Lake,Cottonwood,2,2,0,0
The Lodge of Howard Lake,Wright,6,6,0,0
The Lodge of New Hope,Hennepin,5,5,0,0
The Lodges of Brooklyn Park,Hennepin,1,1,0,0
The Lodges of Burnsville,Dakota,2,0,2,0
The Lodges of Eden Prairie,Hennepin,17,5,12,1
The Meadows of Wadena Senior Living,Wadena,7,4,3,0
The Moments of Lakeville,Dakota,22,14,8,3
The North Shore Estates,St. Louis,16,11,5,0
The Pillars of Highland Park,Ramsey,8,4,4,0
The Pillars of Shorewood Landing,Hennepin,14,9,5,0
The Pillars of White Bear Lake,Ramsey,19,13,6,1
The Pines Senior and Assisted Living,Hennepin,11,5,6,0
The Preserve of Roseville,Ramsey,2,1,1,0
The Residence at Cerenity Marian,Ramsey,18,3,15,3
The Rivers Burnsville,Dakota,3,2,1,0
The Rosemount Senior Living at Steeple Center,Dakota,31,15,16,0
The Sanctuary at Brooklyn Center,Hennepin,76,32,44,3
The Sanctuary at St. Cloud,Sherburne,66,24,42,2
The Shepherds Inn,Faribault,2,1,1,0
The Shores of Lake Phalen,Ramsey,73,31,42,17
The Villa at Bryn Mawr,Hennepin,86,35,51,9
The Villa at Osseo,Hennepin,82,28,54,20
The Villages of Lonsdale,Rice,28,10,18,2
The Waterford,Hennepin,52,17,35,5
The Waters of Eden Prairie,Hennepin,7,4,3,1
The Waters of Edina,Hennepin,35,9,26,10
The Waters of Excelsior,Hennepin,6,3,3,0
The Waters of Highland Park,Ramsey,24,7,17,4
The Waters of Oakdale,Washington,8,4,4,0
The Waters of Plymouth,Hennepin,23,7,16,6
The Waters of White Bear Lake,Ramsey,10,3,7,2
The Waters on 50th,Hennepin,14,6,8,3
The Waters on Mayowood,Olmsted,16,7,9,0
The Waterview Pines,St. Louis,50,22,28,7
The Waterview Shores,Lake,3,2,1,0
The Waterview Shores Assisted Living,Lake,2,1,1,0
The Waterview Woods,St. Louis,60,27,33,12
The Wealshire of Bloomington,Hennepin,36,25,11,4
The Wellington Senior Living,Ramsey,15,7,8,1
Thief River Care Center,Pennington,36,16,20,3
Thomas Feeny Manor,Hennepin,3,3,0,0
Thorne Crest Senior Living,Freeborn,49,19,30,8
Three Links Care Center,Rice,91,49,42,20
Timber Hills,Dakota,13,6,7,3
Timberdale Trace,Steele,37,19,18,4
Tower Light,Hennepin,42,19,23,7
Tradition assisted and independent living,Hennepin,25,16,9,0
Traditions of Montgomery,Le Sueur,13,3,10,1
Traditions of Owatona Two,Steele,1,1,0,0
Traditions of Owatonna,Steele,7,3,4,1
Traditions of Preston,Fillmore,5,1,4,0
Traditions of Waterville,Le Sueur,6,2,4,0
Trails of Orono,Hennepin,36,11,25,9
Traverse Care Center,Traverse,31,10,21,2
Tree of Life Assisted Living,Stearns,12,2,10,0
Trinity Care Center,Dakota,42,28,14,5
Trinity Terrace,Dakota,25,8,17,2
Trouvaille Memory Care,Carver,34,16,18,4
Tuff Memorial Home,Rock,46,11,35,7
Twin Town Villa,Wilkin,17,3,14,1
Twin Valley Assisted Living Center,Norman,9,5,4,2
Urbana Place Senior Living LLC,Hennepin,21,13,8,0
Valentines Assisted Living,Goodhue,5,2,3,1
Valley Assisted Living,Pennington,17,3,14,1
Valley Care and Rehab,Clay,9,7,2,0
Valley View Assisted Living,Jackson,5,5,0,0
Valley View Estates,Todd,4,2,2,1
Valley View Healthcare and Rehab,Houston,3,3,0,0
Valley View Manor,Redwood,37,26,11,2
Valley View of Owatonna,Steele,4,4,0,0
Valleyview of Northfield,Rice,1,1,0,0
Vernon Terrace LifeSprk,Hennepin,7,4,3,1
Victory Health and Rehab Center,Hennepin,79,35,44,6
Viewcrest Health Center,St. Louis,60,26,34,8
Viking Manor Nursing Home,Clay,5,4,1,0
Villa Court LLC,Carlton,2,2,0,0
Villa St. Vincent,Polk,117,57,60,17
Villa at St. Louis Park,Hennepin,30,26,4,1
Village Shores Assisted Living,Hennepin,43,12,31,13
Virginia Carefree Living,St. Louis,4,3,1,0
Vista Prairie at Garnette Gardens,Redwood,30,13,17,3
Vista Prairie at Goldfinch Estates,Martin,7,7,0,0
Vista Prairie at Monarch Meadows,Nicollet,23,14,9,0
Vista Prairie at River Heights,Dakota,26,6,20,9
Vista Prairie at Windmill Ponds,Douglas,9,5,4,0
Wabasso Rehabilitation and Health Care Center,Redwood,5,4,1,0
Walker Methodist Care Suites,Hennepin,52,26,26,4
Walker Methodist Health Center,Hennepin,246,84,162,37
Walker Methodist Highview Hills,Dakota,57,28,29,4
Walker Methodist Levande,Isanti,32,12,20,3
Walker Methodist Place,Hennepin,15,5,10,1
Walker Methodist Plaza,Anoka,100,30,70,10
Walker Methodist WestWood,Dakota,25,13,12,1
Walker Methodist Westwood Ridge,Dakota,43,24,19,2
Warroad Care Center,Roseau,12,8,4,0
Warroad Senior Living Center,Roseau,28,16,12,1
Waters Edge,Blue Earth,7,5,2,1
Watkins Manor,Winona,6,3,3,0
Waverly Gardens - The Gables Care Center - Presbyterian Homes,Ramsey,59,42,17,3
Wayzata Bay Senior Housing Inc. - Folkestone,Hennepin,115,64,51,9
Wealshire of Medina,Hennepin,60,29,31,7
Wellstead of Rogers,Hennepin,66,24,42,25
West Wind Village,Stevens,20,17,3,1
Westview Estates Assisted Living,Renville,6,1,5,0
Westwood Place,Carver,1,1,0,0
Whispering Creek,Waseca,3,3,0,0
Whispering Oak Place,Steele,4,3,1,0
Whispering Pines Cypress Manor,Anoka,6,1,5,0
White Pine Assisted Living,Washington,13,3,10,2
White Pine Assisted Living of Cottage Grove,Washington,51,14,37,7
White Pine Inver Grove Heights Assisted Living,Dakota,7,2,5,0
White Pine Senior Living Mendota Heights,Dakota,13,9,4,1
White Pine Senior Living at Fridley,Anoka,28,6,22,5
White Pines Inver Grove Heights Memory Care,Dakota,17,7,10,1
White Pines White Bear Lake,Ramsey,1,0,1,0
Whitefish at the Lakes,Crow Wing,4,2,2,0
Whitewater Health Services,Winona,3,3,0,0
Wildwood Assisted Living,Benton,12,4,8,3
Willow Creek Senior Community,Otter Tail,4,1,3,0
Willows of Arbor Lakes,Hennepin,22,8,14,6
Willows of Ramsey Hill,Ramsey,7,7,0,0
Windy Acres Long Term Care,Chisago,1,1,0,0
Woodbury Estates,Washington,42,15,27,5
Woodbury Health Care Center,Washington,194,92,102,24
Woodbury Senior Living Woodbury Villa,Washington,29,12,17,4
Woodcrest of Country Manor,Stearns,4,3,1,0
Woodland Lodge,Otter Tail,5,5,0,0
Woodland Manor,Martin,1,1,0,0
Woodlyn Heights Senior Living,Dakota,45,17,28,9
WoodsEdge Senior Living,Beltrami,8,5,3,0
Woodside Manor Assisted Living,Wadena,4,2,2,0
Woodstone Senior Living,McLeod,34,17,17,3
Woodstone Senior Living New Ulm,Brown,41,19,22,5
Worthington Golden Horizons,Nobles,18,1,17,2
York Gardens Senior Living,Hennepin,34,11,23,5
Yorkshire of Edina,Hennepin,32,17,15,0
Zumbrota Care Center,Goodhue,29,12,17,4
